11111111
10E00C01
100P0001
11111101
