1111111111
100P0C0001
10P0000C01
1000E00001
1111111111
