111111111
10P0C0E01
1000T0001
111111111
