111111111111
10000E000001
111111111111
10C0P0000001
111111111111
