1111111111
1000000001
10P0000001
100E00C001
0000000001
1111111111
